name Large Dungeon of Despair
win 5
##################################################
##################################################
####..........................................####
##..............................................##
#................................................#
#................................................#
#................................................#
#........#########...............#########.......#
#................................................#
#...........###.....................###..........#
#..........#.G.#...................#.G.#.........#
#................................................#
#................................................#
###............................................###
#E......................##......................E#
###....................#..#....................###
#.....................#....#.....................#
#......................#..#......................#
#................................................#
#................................................#
#............##....................##............#
#..............####################..............#
#.................#G#.#G##G#.#G#.................#
##..............................................##
#.#............................................#.#
#..#..........................................#..#
#...#........................................#...#
#....#......................................#....#
#.....######################################.....#
##################################################
