name Test Spawn Coords Map
win 2
###################
#G................#
#G.x...G.x.x....E.#
#.......xxx.......#
#..E....xxx.......#
#..........G......#
#..x....x....x....#
#.................#
###################